600
##################
#$  ==      #==  #
#=  =#  #     #  #
##  ==  ## =     #
#   =   #=   ====#
#       ==       #
#=##  =      #   #
#     =   ====== #
# #   =   ##   ! #
#==    =##       #
#     ##   =   ==#
#  #     =##     #
#    !   = =   # #
#  ==   =  ==    #
#!      =   =#   #
#  = =     ##    #
#  #=#  #   #  ! #
##################