480
##################
#$   ==#==  # ! ##
#= =#     #   =  #
#   =      #   ! #
# =    #   #  # =#
#  =      #      #
#     #=     #   #
#  #    =  ! #   #
#  =   = #  =    #
# #    =      #  #
#     !     #  ! #
# #  # #   =     #
#             =  #
# ! #  =   #  =  #
# =         = =  #
#  =# # # = = =  #
#  =  ! =      ! #
##################