420
##################
#$  =#     #   ! #
#=  #   =#  #   ##
# =    =      =  #
##    =  =  !  = #
###  =   # # #  =#
##  !# =  ! #    #
#     =    # #  =#
#=  =  =##   =   #
#  !=#     # #  ##
#= #   # !  #   =#
#  #   =   # # ! #
#      #=  =     #
# #= #  !   # # =#
# ! # ==  =# #   #
#   # =    = !   #
#   = # #    =  =#
##################