360
##################
#$ =#       !    #
#=  #  =#==#  #  #
#  #  =#== #  =  #
#    ##==  #  #! #
# = ##===# #  =  #
# ==  #  ! =  =  #
####= != = ===== #
# ==  # =     !  #
# = ##=  ##  # # #
#  ! ##= !       #
#=   =   = # =# =#
#! #   # !       #
#=  #   =   #  # #
#   = #   #   !  #
#==  ! #   =  #  #
#   =   =   #    #
##################