480
##################
#$ =     #    # !#
##  = ====    =  #
#    #     #=    #
#        #      =#
#   #   =    # ! #
#  =   =!   #   =#
# #   #    = #   #
#=       #     ==#
#  =   =    =  ! #
##    #          #
#   !   # =   =  #
##=  =     #     #
#      #  =    ! #
##   #     =     #
# !  ==  ===#    #
#  =   ======    #
##################