540
##################
#$#           =  #
#  =   =#=   #  !#
#   #      =     #
#    =   #   #=  #
#  #   #=    #=  #
#= !  #  #   #=  #
#   =       !    #
#  #  =#=#=#=    #
#     #   !  =  =#
#  =  ==#=#=   #=#
#     #          #
# = # ==###=#   ##
# # = #=#        #
#     #  =     #=#
#  #  #==    ==#=#
#  !  =    !     #
##################