540
##################
#$    =#      #  #
#=#      #    =  #
# #=   #=  =   ! #
#           #   ##
# # = =#=   =    #
# #   =    =   = #
#     #=#   #    #
#   =   =   =   =#
# #   =#=        #
# #   #    #  =  #
# =   =#      !  #
#     =    =     #
# = !  #=  #   = #
# #  =     =     #
#     =#   #  =  #
#   #    !    #! #
##################