600
##################
#$  ==      =#=  #
## ==   #        #
##  == ### =     #
#       #  = === #
#   =   ==       #
#  # ==      !   #
#    ==   ====== #
#    == !###     #
#    ####        #
#   #### ===   ==#
#        =##     #
#    !   ===   # #
#  ==   =====    #
#       =   =    #
#  ===    ###    #
#   =   #   ##   #
##################