360
##################
#$    =## #  ! = #
###=   =#   =    #
#  =   ##!  ###  #
# !#   =#   ##  !#
#    =#####  =  ##
##    = !    #  =#
#  = !  #  !  =  #
# ##  #     #   =#
#  #  =  #  # #  #
####     =  ######
#  #  # ##  # =! #
# =#    =   #   =#
# !  =#  #  =    #
#=   =  !=#   #  #
## #  #     =#=  #
#  !     #   !   #
##################