420
##################
#$ #  =  #    #  #
##       ===   ! #
#   # #  #   #  =#
#   =    ##      #
#   =   ##==##= =#
#   # =# =  ==  ##
#               !#
# ###### !  #   =#
#   !  #  ! #   ##
# ###########   =#
# #    #         #
# #  ! ######   =#
#!             ! #
# =  =##=# =    ##
##   !      # =  #
#  #  #=#   # #  #
##################